{
    "rows": 8,
    "cols": 12,
    "tileset":[
        [8, 8, 8, 8, 8, 8, 8, 8, 8, 8, 1, 8],
        [8, 8, 8, 8, 8, 8, 8, 8, 8, 8, 1, 8],
        [8, 2, 0, 0, 0, 0, 0, 0, 0, 0, 5, 8],
        [8, 1, 8, 8, 8, 8, 8, 8, 8, 8, 8, 8],
        [8, 4, 0, 0, 0, 0, 0, 0, 0, 0, 3, 8],
        [8, 8, 8, 8, 8, 8, 8, 8, 8, 8, 1, 8],        
        [8, 8, 2, 0, 0, 0, 0, 0, 0, 0, 5, 8],
        [8, 8, 1, 8, 8, 8, 8, 8, 8, 8, 8, 8]
    ],
    "walkable":[
        [-2, -2, -2, -2, -2, -2, -2, -2, -2, -2, -1, -2],
        [-2, -2, -2, -2, -2, -2, -2, -2, -2, -2, -1, -2],
        [-2, -1, -1, -1, -1, -1, -1, -1, -1, -1, -1, -2],
        [-2, -1, -2, -2, -2, -2, -2, -2, -2, -2, -2, -2],
        [-2, -1, -1, -1, -1, -1, -1, -1, -1, -1, -1, -2],
        [-2, -2, -2, -2, -2, -2, -2, -2, -2, -2, -1, -2],        
        [-2, -2, -1, -1, -1, -1, -1, -1, -1, -1, -1, -2],
        [-2, -2, -1, -2, -2, -2, -2, -2, -2, -2, -2, -2]
    ],
    "numEnemies": 3,
    "enemies":[
        {
            "sprite":"turret",
            "type": 0,
            "maxNumber":2
        },
        {
            "sprite":"tank",
            "type": 4,
            "maxNumber":1
        },
        {
            "sprite":"trumpet",
            "type": 1,
            "maxNumber":1
        }
    ],
    "characters":[
        {
            "sprite":"enemy01",
            "initialPos": [7, 2],
            "goal": [0, 10]
        }
    ]
}