{
    "rows": 8,
    "cols": 12,
    "tileset":[
        [12, 13, 8, 8, 8, 12, 13, 8, 2, 0, 0, 3],
        [14, 15, 8, 8, 8, 14, 15, 16, 1, 8, 8, 1],
        [8, 2, 0, 0, 0, 0, 0, 0, 6, 0, 0, 5],
        [16, 1, 8, 8, 8, 16, 8, 8, 16, 8, 8, 8],
        [8, 4, 0, 0, 0, 0, 3, 8, 17, 18, 19, 8],
        [8, 8, 8, 16, 8, 8, 1, 8, 20, 21, 22, 8],        
        [8, 16, 8, 8, 8, 8, 1, 12, 13, 8, 8, 8],
        [0, 0, 0, 0, 0, 0, 5, 14, 15, 8, 8, 8]
    ],
    "walkable":[
        [-2, -2, -2, -2, -2, -2, -2, -2, -1, -1, -1, -1],
        [-2, -2, -2, -2, -2, -2, -2, -2, -1, -2, -2, -1],
        [-2, -1, -1, -1, -1, -1, -1, -1, -1, -1, -1, -1],
        [-2, -1, -2, -2, -2, -2, -2, -2, -2, -2, -2, -2],
        [-2, -1, -1, -1, -1, -1, -1, -2, -2, -2, -2, -2],
        [-2, -2, -2, -2, -2, -2, -1, -2, -2, -2, -2, -2],        
        [-2, -2, -2, -2, -2, -2, -1, -2, -2, -2, -2, -2],
        [-1, -1, -1, -1, -1, -1, -1, -2, -2, -2, -2, -2]
    ],
    "numEnemies": 4,
    "enemies":[
        {
            "sprite":"tank",
            "type": 4,
            "maxNumber":3
        },
        {
            "sprite":"angel",
            "type": 3,
            "maxNumber":2
        },
        {
            "sprite":"turret",
            "type": 0,
            "maxNumber":1
        },{
            "sprite":"trap",
            "type": 2,
            "maxNumber":2
        }
    ],
    "characters":[
        {
            "sprite":"enemy01",
            "initialPos": [7, 0],
            "goal": [0, 11]
        }
    ]
}