{
    "rows": 8,
    "cols": 12,
    "tileset":[
        [24, 25, 25, 25, 25, 25, 25, 25, 25, 1, 25, 26],
        [27, 8, 8, 8, 33, 8, 8, 35, 8, 1, 8, 29],
        [27, 35, 8, 8, 8, 8, 8, 8, 8, 1, 34, 29],
        [27, 8, 38, 0, 0, 0, 23, 0, 0, 23, 0, 0],
        [27, 8, 8, 33, 8, 8, 1, 8, 36, 1, 8, 29],
        [27, 8, 8, 8, 8, 34, 1, 8, 8, 1, 35, 29],        
        [27, 37, 2, 0, 0, 0, 6, 0, 0, 6, 3, 29],
        [30, 31, 1, 31, 31, 31, 31, 31, 31, 31, 1, 32]
    ],
    "walkable":[
        [-2, -2, -2, -2, -2, -2, -2, -2, -2, -1, -2, -2],
        [-2, -2, -2, -2, -2, -2, -2, -2, -2, -1, -2, -2],
        [-2, -2, -2, -2, -2, -2, -2, -2, -2, -1, -2, -2],
        [-2, -2, -1, -1, -1, -1, -1, -1, -1, -1, -1, -1],
        [-2, -2, -2, -2, -2, -2, -1, -2, -2, -1, -2, -2],
        [-2, -2, -2, -2, -2, -2, -1, -2, -2, -1, -2, -2],        
        [-2, -2, -1, -1, -1, -1, -1, -1, -1, -1, -1, -2],
        [-2, -2, -1, -2, -2, -2, -2, -2, -2, -2, -1, -2]
    ],
    "matrix":[
        [-2, -2, -2, -2, -2, -2, -2, -2, -2, -2, -2, -2],
        [-2, -2, -2, -2, -2, -2, -2, -2, -2, -2, -2, -2],
        [-2, -2, -2, -2, -2, -2, -2, -2, -2, -2, -2, -2],
        [-2, -2, -1, -1, -2, -1, -1, -1, -1, -1, -1, -1],
        [-2, -2, -2, -2, -2, -2, -2, -2, -2, -2, -2, -2],
        [-2, -2, -2, -2, -2, -2, -2, -2, -2, -2, -2, -2],        
        [-2, -2, -2, -1, -1, -1, -1, -1, -1, -1, -1, -2],
        [-2, -2, -1, -2, -2, -2, -2, -2, -2, -2, -1, -2]
    ],
    "numEnemies": 4,
    "enemies":[
        {
            "sprite":"turret",
            "type": 0,
            "maxNumber":1
        },
        {
            "sprite":"trumpet",
            "type": 1,
            "maxNumber":1
        },
        {
            "sprite":"trap",
            "type": 2,
            "maxNumber":1
        },
        {
            "sprite":"tank",
            "type": 4,
            "maxNumber":1
        }
    ],
    "characters":[
        {
            "sprite":"enemy01",
            "initialPos": [7, 2],
            "goal": [0, 9]
        }
    ]
}