{
    "rows": 8,
    "cols": 12,
    "tileset":[
        [8, 8, 8, 8, 8, 8, 8, 8, 2, 0, 0, 9],
        [8, 8, 8, 8, 8, 8, 8, 8, 1, 8, 8, 1],
        [8, 2, 0, 0, 0, 0, 0, 0, 6, 0, 0, 5],
        [8, 1, 8, 8, 8, 8, 8, 8, 8, 8, 8, 8],
        [8, 4, 0, 0, 0, 0, 3, 8, 8, 8, 8, 8],
        [8, 8, 8, 8, 8, 8, 1, 8, 8, 8, 8, 8],        
        [8, 8, 8, 8, 8, 8, 1, 8, 8, 8, 8, 8],
        [0, 0, 0, 0, 0, 0, 5, 8, 8, 8, 8, 8]
    ],
    "walkable":[
        [-2, -2, -2, -2, -2, -2, -2, -2, -1, -1, -1, -1],
        [-2, -2, -2, -2, -2, -2, -2, -2, -1, -2, -2, -1],
        [-2, -1, -1, -1, -1, -1, -1, -1, -1, -1, -1, -1],
        [-2, -1, -2, -2, -2, -2, -2, -2, -2, -2, -2, -2],
        [-2, -1, -1, -1, -1, -1, -1, -2, -2, -2, -2, -2],
        [-2, -2, -2, -2, -2, -2, -1, -2, -2, -2, -2, -2],        
        [-2, -2, -2, -2, -2, -2, -1, -2, -2, -2, -2, -2],
        [-1, -1, -1, -1, -1, -1, -1, -2, -2, -2, -2, -2]
    ],
    "numEnemies": 4,
    "enemies":[
        {
            "sprite":"angel",
            "type": 1,
            "maxNumber":3
        },
        {
            "sprite":"turret",
            "type": 2,
            "maxNumber":2
        },
        {
            "sprite":"enemy01",
            "type": 3,
            "maxNumber":1
        },{
            "sprite":"trap",
            "type": 4,
            "maxNumber":2
        }
    ],
    "characters":[
        {
            "sprite":"enemy01",
            "initialPos": [7, 0],
            "goal": [0, 11]
        }
    ]
}