{
    "rows": 8,
    "cols": 12,
    "tileset":[
        [24, 25, 25, 25, 25, 25, 25, 25, 25, 25, 1, 26],
        [27, 8, 35, 8, 8, 33, 8, 8, 37, 8, 1, 29],
        [27, 2, 0, 0, 0, 0, 0, 0, 0, 0, 5, 29],
        [27, 1, 8, 8, 8, 35, 8, 8, 8, 33, 8, 29],
        [27, 4, 0, 0, 0, 0, 0, 0, 0, 0, 3, 29],
        [27, 8, 8, 34, 8, 8, 8, 8, 36, 8, 1, 29],        
        [27, 37, 2, 0, 0, 0, 0, 0, 0, 0, 5, 29],
        [30, 31, 1, 31, 31, 31, 31, 31, 31, 31, 31, 32]
    ],
    "walkable":[
        [-2, -2, -2, -2, -2, -2, -2, -2, -2, -2, -1, -2],
        [-2, -2, -2, -2, -2, -2, -2, -2, -2, -2, -1, -2],
        [-2, -1, -1, -1, -1, -1, -1, -1, -1, -1, -1, -2],
        [-2, -1, -2, -2, -2, -2, -2, -2, -2, -2, -2, -2],
        [-2, -1, -1, -1, -1, -1, -1, -1, -1, -1, -1, -2],
        [-2, -2, -2, -2, -2, -2, -2, -2, -2, -2, -1, -2],        
        [-2, -2, -1, -1, -1, -1, -1, -1, -1, -1, -1, -2],
        [-2, -2, -1, -2, -2, -2, -2, -2, -2, -2, -2, -2]
    ],
    "matrix":[
        [-2, -2, -2, -2, -2, -2, -2, -2, -2, -2, -2, -2],
        [-2, -2, -2, -2, -2, -2, -2, -2, -2, -2, -2, -2],
        [-2, -2, -1, -1, -1, -1, -1, -1, -1, -1, -1, -2],
        [-2, -2, -2, -2, -2, -2, -2, -2, -2, -2, -2, -2],
        [-2, -1, -1, -1, -1, -1, -1, -1, -1, -1, -2, -2],
        [-2, -2, -2, -2, -2, -2, -2, -2, -2, -2, -2, -2],        
        [-2, -2, -2, -1, -1, -1, -1, -1, -1, -1, -1, -2],
        [-2, -2, -1, -2, -2, -2, -2, -2, -2, -2, -2, -2]
    ],
    "numEnemies": 3,
    "enemies":[
        {
            "sprite":"turret",
            "type": 0,
            "maxNumber":1
        },
        {
            "sprite":"trap",
            "type": 2,
            "maxNumber":1
        },
        
            {"sprite":"angel",
            "type": 3,
            "maxNumber":2
        }
    ],
    "characters":[
        {
            "sprite":"enemy01",
            "initialPos": [7, 2],
            "goal": [0, 10]
        }
    ]
}