{
    "rows": 8,
    "cols": 12,
    "tileset":[
        [24, 1, 25, 25, 25, 25, 25, 25, 25, 25, 25, 26],
        [27, 1, 8, 8, 8, 8, 8, 8, 8, 8, 8, 29],
        [27, 1, 8, 8, 8, 8, 8, 8, 8, 8, 8, 29],
        [27, 4, 0, 0, 0, 0, 0, 0, 0, 3, 8, 29],
        [27, 8, 8, 8, 8, 8, 8, 8, 8, 1, 8, 29],
        [27, 8, 8, 8, 8, 8, 8, 8, 8, 1, 8, 29],        
        [27, 8, 2 ,0, 0, 0, 0, 0, 0, 5, 8, 29],
        [30, 31, 1, 31, 31, 31, 31, 31, 31, 31, 31, 32]
    ],
    "walkable":[
        [-2, -1, -2, -2, -2, -2, -2, -2, -2, -2, -2, -2],
        [-2, -1, -2, -2, -2, -2, -2, -2, -2, -2, -2, -2],
        [-2, -1, -2, -2, -2, -2, -2, -2, -2, -2, -2, -2],
        [-2, -1, -1, -1, -1, -1, -1, -1, -1, -1, -2, -2],
        [-2, -2, -2, -2, -2, -2, -2, -2, -2, -1, -2, -2],
        [-2, -2, -2, -2, -2, -2, -2, -2, -2, -1, -2, -2],        
        [-2, -2, -1, -1, -1, -1, -1, -1, -1, -1, -2, -2],
        [-2, -2, -1, -2, -2, -2, -2, -2, -2, -2, -2, -2]
    ],
    "matrix":[
        [-2, -2, -2, -2, -2, -2, -2, -2, -2, -2, -2, -2],
        [-2, -2, -2, -2, -2, -2, -2, -2, -2, -2, -2, -2],
        [-2, -2, -2, -2, -2, -2, -2, -2, -2, -2, -2, -2],
        [-2, -1, -1, -1, -1, -1, -1, -1, -1, -2, -2, -2],
        [-2, -2, -2, -2, -2, -2, -2, -2, -2, -2, -2, -2],
        [-2, -2, -2, -2, -2, -2, -2, -2, -2, -2, -2, -2],        
        [-2, -2, -2, -1, -1, -1, -1, -1, -1, -1, -2, -2],
        [-2, -2, -1, -2, -2, -2, -2, -2, -2, -2, -2, -2]
    ],
    "numEnemies": 4,
    "enemies":[
        {
            "sprite":"turret",
            "type": 0,
            "maxNumber":2
        },
        {
            "sprite":"angel",
            "type": 3,
            "maxNumber":2
        },
        {
            "sprite":"trap",
            "type": 2,
            "maxNumber":2
        },
        {
            "sprite":"trumpet",
            "type": 1,
            "maxNumber":1
        }
    ],
    "characters":[
        {
            "sprite":"enemy01",
            "initialPos": [7, 2],
            "goal": [0, 1]
        }
    ]
}